а был ли мальчик? | Употребляется при сомнениях в наличии самого предмета, давшего повод для беспокойства, хлопот (ирон.).
а Васька слушает, да ест | О том, кто не обращает внимания на уговоры и увещевания и продолжает делать своё (обычно предосудительное) дело.
а всё-таки она вертится | Выражение верности своим взглядам.
авгиевы конюшни | Неподъёмная грязь и запустение
ад кромешный | Место мучений, где условия невыносимы. Ужасная суматоха.
адвокат Божий | (книжн.ирон.) о человеке, способном выгородить (оправдать) любой самый неприглядный поступок.
адвокат Дьявола | (книжн.ирон.) - о человеке, любящем сквернословить в чей-либо адрес, старающемся и в хорошем найти недостатки.
альфа и омега | (книжн. высок.) самая суть, основа чего-либо. Буквально: начало и конец.
ангельское терпение | Бесконечное и доброжелательное терпение
аника-воин | (ирон.) о хвастливом человеке, бахвалящемся своей храбростью лишь находясь вдали от опасности.
аредовы веки | Очень долго.
артель "Напрасный труд" | Заниматься никому не нужным делом
ахиллесова пята | Уязвимое место
бабушка надвое сказала | Непроверенная информация
бабушкины сказки | Какие-либо небылицы
бабье лето | Ясные теплые дни в ранней осени
баки забивать | (жарг.прост.) обманывать кого-либо, пытаться вводить в заблуждение кого-либо.
балансировать на грани | Сильно рисковать
бальзаковский возраст | О возрасте женщины от 30 до 40 лет.
бальзам на душу | О чём-либо, что может успокоить тревогу
беден как церковная мышь | Очень беден, обычно с намёком на голодание
бежать высунув язык | Бежать очень быстро, на пределе сил
бежать, как от чумы | Избегать чего-то очень опасного
без дураков | (прост.) со всей серьезностью, без всяких шуток
без задних ног (спать) | Очень крепко, беспробудно.
без оглядки | Очень быстро; безрассудно
без подвоха | Без подвоха
без понятия | Ничего не знать о чем-либо
без сучка, без задоринки | Идеально, без сложностей
без царя в голове | (ирон.) о взбалмошном, глупом, пустом, неосмотрительном человеке
безвыходное положение | Отсутствие благоприятного варианта
белая ворона | Изгой, также не похожий на других людей.
белая горячка | Алкогольный психоз. Острое отравление алкоголем (сивушным маслом). Выражается бессонницей, дрожанием конечностей, бредом и галлюцинациями зрения и слуха, повышенной температурой.
белены объесться | (грубо-прост.) о том, кто потерял рассудок, ведёт себя, как ненормальный, безумный.
бельмо на глазу | Раздражающий фактор
бередить старые раны | Напоминать о былых горестях, неудачах. Синоним -сыпать соль на рану
беречь как зеницу ока | Оберегать, стеречь как что-либо очень важное
беситься с жиру | Производить неразумные траты (легко доставшихся) средств.
бесплатный сыр | Приманка, заманивающая в ловушку.
бессонная ночь | Ночь тревог, раздумий, решений душевных (психологических) проблем
битый час | Очень длительное время.
бить баклуши | (неодобр.) Бездельничать, заниматься пустяковым делом, праздно шататься; изначально — заниматься совсем простым, лёгким делом.
бить в одну точку | Повторять одно и то же: в действии, в речи
бить ключом | О бурной, полной событий, плодородной жизни.
биться как рыба об лед | Настойчивые, но напрасные усилия (безрезультатная деятельность)
биться об заклад | Спорить на что-либо.
благодатная почва | Хорошие условия для чего-либо
ближе к делу | Призыв к собеседнику переходить к сути разговора. Шутливое «ближе к телу»
блошиный рынок | рынок, на котором торгуют всякой всячиной
блуждать в потёмках | Находиться в неведении; решать проблему, не зная исходных данных
блюдечко с голубой каёмочкой | (неодобр.) То, что достается без усилий, без труда. Преподнести на блюдечке с голубой каемочкой-подарить что-то тому, кто этого не заслуживает, отдать без боя
богатый выбор | Большой, широкий выбор, множество предложений
боевое крещение | Первое участие в каком-либо деле
божий одуванчик | (разг. шутл.; ирон.) О тихом, бесконфликтном и слабом, обычно старом человеке
бой-баба | Боевая, активная, крепкая женщина. Синоним — гром-баба. Совпадение с английским boy случайно.
болтаться без дела | Ничем не заниматься; не знать, чем себя занять
больное место | Слабое, несовершенное место
больной вопрос | Вопрос, не дающий покоя собеседнику
большая шишка | Кто-то важный, значительный, влиятельный человек (Большой человек).
бояться собственной тени | Бояться всего; психоз
брать за душу | Вызывать сильное душевное волнение
брать количеством | Добиваться успеха благодаря большой численности, а не качества
брать на абордаж | (ирон.) Действовать решительно, напористо по отношению к кому-, чему-л.
брать на испуг, Брать на пушку | пугать, часто необоснованно, Блефовать
брать под крыло | Заботиться о ком-либо
брать под патронаж | Брать под крыло
брать с потолка | Выдумывать (данные)
браться за ум | Становится благоразумнее, рассудительнее
братья наши меньшие | Животные
бред сивой кобылы | Полная бессмыслица
бровью не повёл | Внешне не проявил эмоций
бросать камни в чей-либо огород | Намекать на кого-либо
бросать слова на ветер | Говорить безответственно, не отвечая за свои слова
бросаться в глаза | Сразу же привлекать внимание
бросить в беде | Не помочь кому-либо в нужный момент
бросить тень | Создать неблагоприятное впечатление о чем-нибудь или о ком-нибудь
брызгать слюной | С пеной у рта
бумага всё стерпит | Напоминание о том, что любая письменная информация может быть ложью.
буриданов осел | О том, кто, при двух равных возможностях выбора, не может принять решение
буря в стакане (воды) | Большие волнения по ничтожному поводу.
была б моя воля/будь моя воля | Взгляд говорящего на проблему, его способ решения проблемы
быльём поросло | Давно забыто, стёрлось в памяти (о том, что безвозвратно прошло)
быть в фаворе | Быть в милости, пользоваться расположением кого-либо. Быть любимцем
быть не в своей тарелке | Испытывать неловкость, находясь в непривычной обстановке
В (не) лучшей форме | Недоделанный, не готовый, испорченный
в бегах | Скрываться от властей или правоохранительных органов средством изменения места пребывания
в глубине души | Скрытое чувство
В зените (успеха/славы) | В момент наивысшего (успеха/славы)
в идиотском положении | В идиотском положении
в курсе | Быть ознакомленным с чем-либо
в ногах правды нет | Приглашение сесть
в открытую | действовать/говорить напрямую, ничего не скрывая
в отцы годится | Намного старше/опытнее
в печёнках сидеть | Очень надоесть
в пику | Делать что-то демонстративно
в подмётки не годится | Означает, что сравниваемый предмет гораздо хуже другого
вполуха | Слушать невнимательно
в полном разгаре | В полном разгаре
В поте лица (работать) | Добросовестно выполнять тяжелую работу
в пределах разумного | Совершать действия в рамках принятой морали,
в прекрасной форме | Находиться в хорошей физической форме
в разумных пределах | В пределах разумного
в расцвете | В расцвете
врезать дуба | Умереть
в своём уме | Действовать/говорить разумно
в сердцах | Действовать/говорить по первому побуждению
В сто раз лучше/хуже | Во много раз лучше/хуже
в центре внимания | Событие/человек, на которое все обращают внимание
в час по чайной ложке | Очень медленно
в четырёх стенах | Дома, в помещении, не выходя на улицу
в чистом поле | Там где нет людей и помощь со стороны маловероятна
вавилонское столпотворение | (книжн.) беспорядочная толпа людей, суматоха, неразбериха
валить в одну кучу | Не разграничивать понятия разной природы
валить с больной головы на здоровую | Перекладывать свои проблемы/задачи на другого
валять дурака | 1) притворяться непонимающим, глупым; паясничать, дурачиться. 2) бездельничать, праздно проводить время.
ваньку валять | Бездельничать
вариться в собственном соку | Не иметь возможности общаться с кем-то извне
вашими молитвами | (разг. шутл.) ответ на вопрос: ”Как поживаете?”, ”Как ваше здоровье?” в значении ”спасибо, ничего” как выражение благодарности за участливое отношение.
вбить в голову | Запомнить раз и навсегда; заставить запомнить
вверх тормашками | Кувырком, через голову, вверх ногами; вверх дном, в полном беспорядке.
вгонять в краску | Смущать
вдобавок ко всему | Вдобавок ко всему
вернёмся к нашим баранам | Вернёмся к теме разговора. Призыв к говорящему не отвлекаться от основной темы; констатация говорящим того, что его отступление от темы разговора окончилось и он возвращается к сути
вертеться как белка в колесе | Иметь много хлопот
вертеться на языке | Говорится о ситуации, когда человек старается вспомнить что-то, знает, что это ему известно, но вспомнить не может
верхушка общества | Элита
вешать нос | Впадать в уныние/отчаяние
взрывоопасный вопрос | Вопрос, могущий привести к непредсказуемым, но сильным последствиям
взять быка за рога | Сразу приступить к делу/разговору и т.п.
взять на вооружение | Принять к сведению; учесть что-то для дальнейшего использования
видеть насквозь | Понимать скрытые мотивы поведения человека
вилами по воде писано | О неподтвержденных и маловероятных данных
висеть на волоске | Риск очень велик
витать в облаках | Предаваться несбыточным мечтам, не замечая окружающего
вить верёвки из кого-либо | Манипулировать кем-либо
вкладывать душу | Относиться к делу ответственно и с любовью
властитель дум | (книжн. высок.) выдающийся человек, оказывающий сильное духовное и интеллектуальное влияние на своих современников
власть имущие | (книж.) о тех, кто стоит у власти (имеющие власть)
во всю глотку | Очень громко
во всю Ивановскую | Очень громко.
во всю прыть | Быстро
Во главу угла (ставить что-л.) | Признавать что-либо главным, особо важным.
водить за нос | Обманывать, вводить в заблуждение
водой не разольёшь | О крепкой дружбе
вожжа под хвост попала | О человеке, который неожиданно начинает совершать необдуманные, нелогичные действия
воздушные замки | Иллюзии
Возить воду (на ком-л.) | Обременять кого-л. тяжелой и унизительной работой, беспощадно эксплуатировать, пользуясь его покладистым характером
войти в историю | Прославиться
волк в овечьей шкуре | О лицемере, прячущем под маской добродетеля свои злые намерения
вооружённый до зубов | Подготовленный к чему-либо
вопрос жизни и смерти | Очень важный вопрос
ворошить прошлое | Вспоминать прошедшие (неприятные) события/поступки
восьмое чудо света | О чём-либо необычном, удивительном, выдающемся
вот в чём загвоздка | Вот в чём суть дела!
Вот тебе и... | Вот тебе и...
Вот тебе, (бабушка), и Юрьев день | (ирон., шутл.) о неожиданно не сбывшихся надеждах, внезапных переменах к худшему; резком ограничении свободы действий
Вперёд батьки (в пекло лезть/соваться) | О ненужной поспешности в деле, решении, чаще неприятном и таком, которое лучше не делать самому
врагу не пожелаешь | О чем-то негативном
врать и не краснеть | Нагло, беззастенчиво врать
врать как сивый мерин | Нагло, беззастенчиво врать
время пошло | Процесс начался; нужно действовать быстро
время терпит | Можно не торопиться
всё или ничего | О готовности к трудностям
Всё к тому/этому идёт | События происходят в известном направлении
всё наоборот | Все наоборот
Всё не так просто (как кажется) | Указание на сложность ситуации вопреки поспешным выводам
Всему своё время/срок | Указание на поспешность события/вывода
всех дел не переделаешь | Невозможно все успеть
вставать с петухами | Очень рано просыпаться
вставить слово | Заговорить
вставлять палки в колеса | Мешать чему-либо
встать не с той ноги | Проснуться/быть в плохом настроении без особой причины
встреча без галстуков | Встреча политиков или бизнесменов в «неформальной обстановке», без соблюдения большинства полагающихся норм протокола
втереться в доверие | Заставить человека доверять себе
втирать очки | Обманывать кого-либо, представлять что-либо в выгодном свете
вторая скрипка | Человек, находящийся на вторых ролях, не лидер
второе дыхание | Новый прилив сил
второе рождение | Удачный исход сложной ситуации
второй дом | Родное, значимое место
вцепиться в глотку | Крепко ухватиться
выбить из колеи | Заставить нарушить привычный образ жизни; вывести кого-л. из обычного состояния
выбить почву из-под ног | Лишить опоры
выброшенные деньги | Деньги, потраченные зря
вывалять в грязи | Оговорить человека, оклеветать
вывести на чистую воду | Уличить во лжи
выворачивать кому-л руки | Ограничивать свободу действий
выгадывать на мелочах | Получать выгоду из мелочей
выгодная сделка | Хорошая сделка
выдавить улыбку | Улыбаться через силу, неохотно
выдать на-гора | Предъявить сделанную работу, произвести какую-л. продукцию (из речи шахтеров)
выжать всё, что можно | Заставить выложиться, работать в полную силу
выжить из ума | Сойти с ума
выйти в тираж | Прекращение активной деятельности
выйти из себя | Начать нервничать
выйти из-под контроля | О невозможности уследить за чем-либо
выйти сухим из воды | Без плохих последствий
выложить без обиняков | Сказать прямо
вымещать на | Вымещать на
вынашивать честолюбивые планы | Строить честолюбивые планы
выносить сор из избы | Обсуждать с посторонними (чьи-то) личные проблемы
выпрыгивать из штанов | 1. (неодобр.) Активно действовать, чтобы быть замеченным и поощренным начальством. 2. Сильно радоваться.
выпустить кишки | Убить
вырыть себе яму | Действовать себе во вред
высказать всё что думаешь | Высказать своё отношение (чаще негативное)
высокие материи | Философские вопросы
высосанный из пальца | Выдуманный
вытолкать взашей | Выгнать с помощью грубой силы
вытрепать нервы | Заставить сильно волноваться
газетная утка | Сообщение, содержащее зачастую неверную, ошибочную или непроверенную информацию, откровенную ложь
галопом по Европам | (шутл.) о крайне поверхностном, делаемом в спешке ознакомлении с чем-либо
гвоздь программы/сезона | 1) наилучший номер, наилучший артист в концерте, производящий сенсацию. 2) наилучшая программа чего-либо
где наша не пропадала | Опытные люди могут выйти из сложной ситуации
где собака зарыта | В чем главная причина
геенна огненная | Ад, преисподняя
глаза на лоб полезли | Сильно удивиться
глаза на мокром месте | Часто и много плакать по незначащим поводам
гладить против шерсти | 
глаза разбегаются | О большом выборе
глаза слипаются | Засыпать
глазом не моргнуть | Вести себя спокойно
глас вопиющего в пустыне | Не встретить поддержки в своих просьбах
глухой как тетерев | Абсолютно глухой
гнать волну | Начинать сплетни, толки
гнетя концы | 1) делать всё наоборот 2) делать всё неправильно
Гнуть (свою) линию | Делать по-своему
говорить все как есть | Говорить начистоту
говорить на разных языках | Не понимать друг друга
говорить обиняками | Говорить намеками
Говорить одно, а думать другое (делать третье) | Говорить одно, а думать другое (делать третье)
говорить полуправду | Недоговаривать
гол как сокол | Беден
голова идёт кругом | Об умственном перенапряжении
головная боль | Постоянно или часто проявляющаяся проблема
голод не тетка | Голод не может быть утолен ничем, кроме еды
голодный как волк | Очень голодный
голубая кровь | Благородное, высокородное происхождение
голубая мечта | Заветная мечта
голый энтузиазм | О человеке с жаждой деятельности, но без знаний или средств
гомерический хохот | Очень сильный, громкий смех
гора с плеч | О быстром разрешении крупной проблемы
гордиев узел | Означает сложную и запутанную проблему, ситуацию. Разрубить Гордиев узел - избавиться от проблемы самым решительным путем.
горе луковое | Маленькое горе
горы свернуть | Совершать великие дела
горькая правда | Горькая правда
гражданский брак | Не зарегистрированный официально брак, сожительство
грести лопатой | Получать максимальную прибыль
грести под себя | Стремиться получить как можно больше прибыли, выгоды
греть душу | Радовать
грозный вид | Устрашающий вид
грош цена | Грош - самая мелкая монета, меньше которой не было. Очень низкая цена, бесценок.
гроша ломаного не стоит | Ничего не стоящий, пустяковый.
грызть гранит науки | Учиться
да ещё каких мало | Да ещё каких мало
давить на жалость | Пытаться уговорить кого-либо, вызывая у него чувство жалости
дать добро | Согласиться, разрешить
дать дуба | Умереть
Дать сто очков вперед (кому/чему) | Быть значительно лучше (кого/чего)
два сапога пара | Очень похожие друг на друга
двойная бухгалтерия | Двойная бухгалтерия
девичья память | Плохая, короткая память
действовать по обстановке | Действовать по обстановке
дела давно минувших дней, преданья старины глубокой | 
Делать (всё) по своему | Делать (всё) по своему
Делать веселую мину (при плохой игре) | Притворяться, что ситуация лучше, чем на самом деле
делать из мухи слона | Преувеличивать
дело в шляпе | Проблема близка к разрешению
дело выгорело | Дело завершено успешно
дело десятое | Нечто непервоочередное, неважное
дело пахнет керосином | Дело идет к неприятным последствиям
Дело табак/дрянь | Негативная ситуация
деловая колбаса | (ироничн.) Деловой, серьезный
денег как грязи | Денег очень много
деньги на бочку | Призыв немедленно отдать деньги
держать в ежовых рукавицах | Держать в строгости, ограничивать.
держать в напряжении | Держать в напряжении
держать на коротком поводке | Давать мало свободы
держать на расстоянии | Избегать встреч
держать нос по ветру | Следить за ситуацией
держать руку на пульсе | Следить за ситуацией
держать язык за зубами | Молчать, хранить тайну
держаться в тени | Действовать скрыто, неявно, не обращать на себя внимание
держаться на плаву | Успешно вести дела
держаться подальше от | Держаться подальше от
держи карман шире | О пустых надеждах
дирол с ксилитом | Бесполезное дело,тягомотина
Длинный язык (слишком) | о болтуне
для галочки | Для галочки
до второго пришествия | На долгий срок
до мозга костей | О человеке: полностью, совершенно
до победного конца | До победного конца
до посинения | Очень долго
до свадьбы заживет | О небольших ранах, травмах
до точки | До точки
до хрипоты | Очень долго, бессмысленно спорить
добраться до сути | Добраться до главной темы рассуждений
добровольно-принудительный | Принудительный, но имеющий видимость добровольности
доводить до белого каления | Раздражать до крайности
доводить до ума | Заканчивать работу
дойная корова | Дойная корова
дойти до точки | 1. Закончить, 2. Придти в какое-либо состояние ("Потом не помню - дошел до точки" (с) Владимир Высоцкий, т.е. допился до неадекватного состояния)
долгая история | Долгая история
дом терпимости | Бордель
допиться до чертиков | Очень сильно (до психических расстройств) напиться
дорогу осилит идущий | Для успешного выполнения задачи надо за нее взяться
досконально знать все тонкости | Досконально знать все тонкости
доставать кого-либо | Надоедать кому-либо
дошло как до жирафа | о человеке, медленно понимающем
драть как Сидорову козу | Сильно наказывать (розгами, ремнем)
дрожать как осиновый лист | Сильно дрожать
душа нараспашку | Открытый человек
Душа общества/компании | тот, кто развлекает, является центром компании, заводила
души не чаять | безгранично любить; обожать, доверяя во всём.
душой и телом | Душой и телом
дырка от бублика | Ничего
дышать на ладан | Быть в плохом, изношенном состояними (о вещи), или быть еле живым, умирать (о человеке)
дьявол во плоти | Плохой человек
единственный и неповторимый | Уникальный
ежовые рукавицы | Строгий надзор
ежу понятно | Очень просто
еле дышит | Очень слаб, устал, болен (о человеке); сильно изношен (о вещи)
еле-еле душа в теле | 
если б да кабы | Если б да кабы
если уж на то пошло | Если уж на то пошло
есть ещё порох в пороховницах | Есть у меня ещё силы
етишкина жизнь | Бедовая, безрадостная жизнь
ёлки зелёные | восклицание удивления или досады.
Ёпэрэсэтэ | эвфемизм нецензурной брани
Ёшкин кот | эвфемизм нецензурной брани

ёшки матрёшки
Ёкарный бабай | эвфемизм нецензурной брани
ждать своего часа | Терпеливо ждать
ждать у моря погоды | Ждать благоприятных условий, которые вряд ли сложатся
желать невозможного | Желать невозможного
железный занавес | полная изоляция чего-либо
жёлтая пресса | периодические издания, зачастую пишущие неправду или скандальные новости
жив, курилка! | (шутл.) Живой
живем один раз | Живем один раз
жизнь в розовом свете | Беззаботная жизнь
жизнь продолжается | Ничего страшного
жиртрест | (груб.) О толстом человеке
житейская мудрость | Житейская мудрость
житейский опыт | Опыт, приходящий с годами, полученный в ходе жизни
жить своим умом | Думать самому, соображать своей головой, не полагаясь на чужие советы
жить чужим умом | Бездумно полагаться на советы других
жопа с ручкой | О вредном человеке
жребий брошен | Выбор сделан
за длинным рублем погнаться | Заняться добыванием денег, кажущихся легкими, обычно в ущерб образованию или карьере
за душой ничего нет | 1. Беден, нищ (о человеке) 2. Абсолютно бездуховный человек
за семь верст киселя хлебать | 1. Ходить очень далеко за пустым, неважным делом. 2. Потратить много времени и сил ради пустякового результата.
за того парня | Вместо кого-то другого
забегать вперед | Приступать к чему-либо, не сделав то, что должно быть сделано раньше
забить на что-либо | Перестать обращать на что-то внимание
забить стрелку | Назначить встречу
заварить кашу | Создать проблему
завинтить гайки | Принять меры, запретить что-л.
завязать с чем-либо | Закончить пользоваться, употреблять что-либо
загнать себя в угол | Поставить себя в сложную ситуацию
загореться желанием | Сильно захотеть
задать жару | Избить, поколотить. В общем случае - победить, разгромить
задеть за живое | Затронуть сильно интересующую тему
задирать нос | Гордиться, хвастаться
задняя мысль | Мысль, возникающая позже ситуации. Без задней мысли - впрямую, честно.
задушевный разговор | Откровенный разговор
заживет как на собаке | Быстро заживет
зайти на огонек | Зайти в гости
зайти слишком далеко | Позволить себе многое
закидать шапками | Добиться успеха за счет наглости
закадычный друг | Лучший друг
заклятые враги | Смертельные враги
заколдованный круг | 
закрывать глаза на что-либо | Намеренно не обращать внимания на что-то
закусить удила | Заупрямиться, даже осознавая, что делаешь себе же хуже
залезть под юбку | Прибегнуть к защите женщины
залечь на дно | Спрятаться
зализывать раны | Восстанавливать утраченное/проигранное
замкнутый круг | Ситуация, которая не имеет решений
заморить червячка | Быстро перекусить
занимать особое положение | Занимать особое положение
Зарубить (себе) на носу | Запомнить
застать врасплох | Застать неподготовленным, неспособным защититься, как то ответить, внезапно застигнуть
засучить рукава | Изготовиться к работе, создать серьезный настрой на работу
затаив дыхание | С максимальным напряжением (о человеке)
затишье перед бурей | Затишье перед бурей
заткнуть за пояс | Быть лучше кого-то в какой-то области
затмить кого-л | Оказаться намного лучше
затянуть пояс | Приготовиться голодать
зашибать деньги | (неодобр.) Получать большие деньги
звёзд с неба не хватает | Не выдающийся человек
зелёный змий | Алкоголь
земля обетованная | Место, идеально подходящее для какой-либо деятельности
злачное место | место, где предаются кутежам, разврату (соврем.)
злой язычок | Саркастичный, ядовитый человек
Змея/гадюка подколодная | Хитрый, злой, ядовитый человек
знать назубок | Знать наизусть
золотая молодёжь | Дети богатых родителей
зубы заговаривать | Врать,запутывать
и волки сыты, и овцы целы | Решение проблемы, одинаково удобное для обеих сторон
и иже с ним | (устар.) И те, которые с ним
и на старуху бывает проруха | ошибиться может каждый
и нашим и вашим | Угодить всем
и ухом не повел | Не отреагировал
Игра (не) стоит свеч | Выгода от предприятия (не) превышает затраты на него же
игра в одни ворота | Ситуация, в которой одна сторона получает все плюсы, вторая же несет все проблемы
играть в бирюльки | Заниматься малозначимым делом
играть в кошки-мышки | Соревноваться с заведомо неравными партнерами
играть краплёными картами | Мошенничать
играть на публику | Действовать так, чтобы вызвать симпатии публики
играть с огнем | рисковать
идея фикс | Навязчивая идея
идти куда глаза глядят | идти в любое место, не зная куда идёшь
идти на поводу у кого-л | Постоянно слушаться чьих-то советов, указаний, просьб
идти напролом | Действовать, не считаясь с трудностями, преградами, своими и чужими интересами
идти по головам | Действовать в своих интересах, ущемляя чужие
идти по ложному следу | Делать ложные выводы, со всеми вытекающими
Идти по (чьим-то) стопам | Заниматься тем же, чем и предшественник
идти своим чередом | Происходить как и должно
из грязи - в князи | (неодобр.) О человеке, ничего не стоящем сам по себе, но неожиданно добившегося высокого поста. Либо, о человеке из самых низов, добившегося высокого поста.
из кожи вон лезть | очень стараться
из первых рук | От очевидца, участника
Из пустого в порожнее (переливать) | Заниматься пустыми, бессмысленными рассуждениями
Из пушки по воробьям (стрелять) | Привлекать значительные средства для достижения незначительных целей
Из ряда вон (выходящий) | Необычный, уникальный
из ума вон | Сошел с ума
из уст в уста | (обычно о слухах, молве) распространяемые людьми, пересказывающими их друг другу
избиение младенцев | Обижать беззащитных людей
изо всех сил | Изо всех сил
изо всех щелей | Отовсюду
изобретать велосипед | Придумывать или вносить ненужные модификации в уже существующее
из-под земли достать | Найти, несмотря на все трудности
иметь успех | Иметь успех
имеющий уши да слышит | 
искра божья | что-то особенное, яркое
искать днём с огнём | 
искать с собаками | 
испорченный телефон | передача недостоверных сведений от одного к другому
испустить дух | Умереть
ищи ветра в поле | Бесполезно искать
ищи-свищи | Бесполезно искать.
каждой бочке затычка | Человек, дающий советы всем, независимо от того, нужны ли эти советы
каждому своё | Не бывает одинаковых людей, одинаковых ситуаций. В каждом конкретном случае получается свой результат. Каждый получает то, чего достоин.
Как банный лист (пристать) | Надоедать, быть навязчивым
Как белка в колесе (крутиться) | Активно, суматошно исполнять однообразную работу
как бельмо на глазу | 
Как Бог на душу положит | Как попало
как в воду кануть | Исчезнуть без следов
как гром среди ясного неба | Неожиданно
Как два пальца об асфальт | Нечто сделать просто, как ...
Как две капли (воды) | Похожи, неотличимы
как из ведра | В большом количестве. О дожде (льет, как из ведра) - сильный дождь
как мертвому припарки | бесполезно, попусту
как пчёлы на мёд | О чем-либо, привлекающем внимание
как ни в чем не бывало | Будто бы ничего не случилось
как ни крути | В любом случае, при любых обстоятельствах
Как об стенку/стену горох | О человеке, не понимающем объяснения
как огурчик | О человеке: свежий, выспавшийся, трезвый
как пить дать | Точно, несомненно
как по маслу | Легко, складно
как с гуся вода | Кому-либо что-либо абсолютно безразлично, все нипочем
как с цепи сорвался | Стал вести себя буйно, неразумно
Как селёдка (сельди) в бочке | теснота
как сквозь землю провалиться | Бесследно исчез
как снег на голову | Неожиданно, вдруг
Как сыр в масле (кататься) | Жить в достатке
как у Христа за пазухой | Жить беззаботно, в полной безопасности
Как угорелый (носиться/бегать) | (неодобр.) Много и быстро бегать.
калачом не заманишь | Никакими посулами не заставить выполнить что-либо (преимущественно заехать или зайти куда-либо)
калиф на час | 
Камень преткновения | Объект спора
камня на камне не оставить | Полностью разрушить, или (перен.) резко раскритиковать
кануть в вечность | о времени: пройти, уйти в прошлое
кануть в Лету | Быть навечно забытым, преданным забвению, исчезнуть бесследно и навсегда
Катись колбаской (по Новоспасской, Малой Спасской) | выпроваживать («иди-ка ты отсюда» (или «гуляй, Вася», «скатерью дорожка», «иди к чёрту»)
катиться по наклонной плоскости | Постепенно становиться все хуже и хуже
качать права | Предъявлять претензии, ссылаясь на что-либо не особо важное
каша в голове | Сумбур, сумятица в мышлении
Каши не сваришь (с кем-либо) | Не сговоришься, не сделаешь какого-либо дела с кем-либо
кесарю кесарево, а Богу Богово | Каждому свое
кидаться из крайности в крайность | О непоследовательном, мечущемся человеке
кисейная барышня | 
Китайская грамота | Что-то непонятное, сложное для понимания
кишмя кишит | О множестве беспорядочно движущихся живых существ: людей, животных, рыб, насекомых и пр.
кладезь знаний | Очень умный человек
Класть (положить) зубы на полку | (шутл.) Испытывая нужду, ограничивать себя в самом необходимом, голодать
клеймить одним клеймом | Ставить в один ряд
клиент всегда прав | Клиент всегда прав
Клин клином вышибать (выгонять) | Подобное побеждается подобным
книга за семью печатями | О чем-либо абсолютно непостижимом, недоступном пониманию, скрытом от непосвященных
кнут и пряник | Метод поощрений и наказаний
Когда жареный петух (в одно место) клюнет | 1. При возникновении сложной проблемы. 2. Никогда
когда как | В разных ситуациях по-разному
Когда припрёт/прижмёт | При возникновении сложной проблемы
когда рак на горе свистнет | Никогда
козел отпущения | Человек, на которого постоянно сваливают ответственность за ошибки, проступки, грехи других
колесо Фортуны | Слепая судьба, превратности, непостоянство человеческого счастья
комок нервов | Нервный человек
Кондрашка (Кондратий) хватил | Умер скоропостижно
коней на переправе менять | Менять работников в процессе работы.Коней на переправе не меняют
концерт окончен | Об окончании какого-либо действия
конь не валялся | Работа не начата
коптить небо | Жить без цели, существовать
короче говоря | Употребляется перед изложением сути дела
корчить из себя | Изображать из себя
косить от армии | Уклоняться от армейской службы
кот валяка | Лентяй
кот в мешке | Нечто неизвестное, с неизвестными качествами
кот наплакал | очень мало,немного
коту под хвост | Впустую
кошмар наяву | Воплощение страшных фантазий
краем глаза | Невнимательно
краем уха услышать | Услышать случайно, слушая невнимательно
крамольная мысль | Недостойная мысль, связанная с интригами, происками
крепок задним умом | Понимает, что нужно было делать, уже когда становится поздно
кровь в жилах стынет | Очень страшно
кровь с молоком | Здоровый, крепкий человек
крокодиловы слезы | Неискреннее сожаление, сострадание
крупица правды | Очень мало правды
крылатые слова | Образные выражения, цитаты и идиомы, которые получили широкое распространение
кто бы говорил | В ситуации, когда судящий сам находится в такой же ситуации и поступает противоположно своим словам.
кто в лес, кто по дрова | Несогласованность в совместных действиях
куда глаза глядят | В в любую сторону, куда угодно
куда Макар телят не гонял | Очень далеко
купаться в деньгах | Быть очень богатым
купаться в золоте | Быть очень богатым
купаться в роскоши | Быть очень богатым
курам на смех | Смешно, никуда не годится
курица лапой | Кривой, некрасивый почерк
курить фимиам | Восхвалять
кусать локти | Злиться
лакомый кусочек | То, что желательно получить в пользование
лапу сосать | Голодать
лебединая песня | Прощальная, последняя песня, прощание; финал; заключительный этап процесса
лебезить перед кем-либо | Унижаться, похалимничать перед кем-либо, льстить
легкие деньги | Деньги доставшиеся без особого труда
легко сказать | Трудности, большие проблемы выполнения, совершения того, о чём говорится
легок на помине | Человек, который появляется, когда о нем говорят
лезть в бутылку | 1) Выставлять себя с невыгодной позиции 2) Очень сердиться, горячиться, выходить из себя
Лезть на рожон | 1) Без нужды показывать себя 2) Глупое поведение, которое может навредить
лёд тронулся | Дело началось
литр-бол | Употребление алкогольных напитков
Лица нет | Заметное изменение внешнего облика человека вызванное сильным потрясением, болезнью или волнением.
ловить каждое слово | Внимательно слушать, вникая в тему
ловить на слове | Запоминать сказанное собеседником, обещая в дальнейшем припомнить
ловить рыбу/рыбку в мутной воде | Извлекать для себя выгоду, не афишируя этого
ловля блох | Бесполезное внимание к мелочам, стремление исправить мелкие недостатки, не обращая внимания на крупные
ложиться спать с курами | Ложиться спать очень рано, с наступлением сумерек
Ложка дёгтя в бочке мёда | Изъян, недостаток, существенно снижающий всю совокупность положительных качеств объекта
ложь во спасение | Сокрытие правды для обеспечения сохранности объекта
Ломать голову | Напряженно думать над чем-нибудь
ломиться в открытую дверь | Применять силу там, где нет необходимости
лыка не вяжет | Пьян настолько, что не может говорить членораздельно
львиная доля | Большая часть чего-либо
любопытная варвара | Сверх меры любопытный человек
лямку тянуть | Выполнять по необходимости неинтересную работу
ляпнуть не подумав | Сказать что-либо не подумав о последствиях
мальчик на побегушках | Мальчик на побегушках
маменькин сынок | Несамостоятельный человек (о мужчине)
манна небесная | Неожиданное счастье
мартышкин труд | Бесполезный, напрасный труд
медведь на ухо наступил | Абсолютное отсутствие музыкального слуха
медвежий угол | Глухое место
медвежья услуга | Услуга, приводящая к результату противоположному ожидаемому
медленно, но верно | Медленно, но все же приближаясь к успешному завершению
между молотом и наковальней | Находиться в сложной ситуации, в которой надо быть очень осторожным
между нами | Приватно, секретная информация, тайна
меж двух огней | Находиться в сложной ситуации, в которой надо быть очень осторожным
между Сциллой и Харибдой  | Находиться в сложной ситуации, в которой надо быть очень осторожным
мерить всех на свой аршин | Судить людей по себе, по своим делам
места не столь отдаленные | Места заключения, тюрьма
место под солнцем | Жизненное пространство
метать бисер перед свиньями | Совершать бесполезные действия
метать петли | Обманывать
методом проб и ошибок | Опытным путем находить решение
мечта идиота | Несбыточная мечта
мёртвого осла уши | Шиш, кукиш, ничего и никогда (тж. от селёдки ухо; дырка от бублика)
мёртвые души | О том, чего нет на самом деле, но есть по документам
мизинца не стоит | Абсолютно бесполезная вещь (тж. Никчемный человек)
мир тесен | О неожиданной встрече со старым знакомым
мозолить глаза | Надоедать кому-либо
мокрая курица | (неодобр.) Никчемный человек
мокрый как мышь | Сильно промокший/вспотевший
молочные реки, кисельные берега | Сказочное место, где все доступно, все рядом
молчать не станет кто-либо | Молчать не станет кто-либо
момент истины | Момент, когда ситуация становится ясной
море слёз (пролить) | Много плакать
мороз по коже | Состояние страха, волнения
мрачнее тучи | Очень сердитый
мурашки по коже | Волнение, страх
мутить воду | сознательно запутывать какое-либо дело, сбивать с толку или вносить путаницу
мухи не обидит | Совершенно безобидный
мыслить широко | Смотреть на проблему иначе, рассматривать больше ее аспектов, чем принято
мягко выражаясь | Выражаться более культурно, чем требует ситуация
на «ты» | очень хорошо разбирающийся в вопросе
на взводе | в состоянии сильного возбуждения
на волне успеха | на волне успеха
на всю катушку | максимально возможно, очень сильно
на голом энтузиазме | абсолютно бескорыстно (бесплатно)
на грани фола | в условиях близких к нарушению установленных правил
на гребне волны | на гребне волны
на два фронта | в двух абсолютно разных направлениях
на дне | низко (в т. ч. в переносном смысле)
вызывать на ковёр / на ковёр вызывать | быть вызванным к начальнику для получения (выслушивания) замечаний
на круги своя | возвращаться в исходное состояние
на кудыкину гору | далеко
на ножах | о напряжённых отношениях
на переднем крае | на переднем крае
на повышенных тонах | громко, раздражённо
на полную катушку | максимально возможно, очень сильно
на последнем издыхании | из последних сил
на посошок | о рюмке перед уходом гостей
на произвол судьбы | бросать, оставлять без помощи
на пушечный выстрел не подходить / на пушечный выстрел не пускать | отдаляться, отгораживаться
на распутье | в ситуации сложного, важного выбора
на своем месте | там, где больше всего пригодится
на своих двоих | пешком
на сегодня хватит | достаточно
на седьмом небе | <быть на седьмом небе> — чувствовать себя безмерно счастливым (<на седьмом небе от счастья>)
на сон грядущий | делать что-либо перед сном
наступать на те же грабли / на те же грабли наступать | повторять одну и ту же ошибку
на птичьих правах | неофициально, без законных оснований
на чемоданах | о готовности к поездке, переезду
на чёрный день | к тому времени, когда настанут худшие времена
набит деньгами | очень много денег
навёрстывать упущенное | догонять, в ускоренном темпе входить в курс дела
наводить тень на плетень | усложнять речь, делать её непонятной
навострить уши | слушать очень внимательно
наглый лжец? | наглый лжец
нагнать страху | без нужды запугать
нагнетать атмосферу | преувеличивать серьёзность ситуации
настроиться на новый лад | привыкнуть к новому порядку
надувать губы | обижаться
называть вещи своими именами | быть искренним
найти общий язык | добиться взаимопонимания
наломать дров | сделать что-либо поспешно, не посоветовавшись, неправильно
намотать себе на ус | запомнить навсегда
напрашиваться на комплименты | сознательно создавать ситуацию, в которой собеседник вынужден будет сделать комплимент
напрашиваться на неприятности | сознательно создавать себе неприятности, вмешиваться в неприятную ситуацию без нужды
наставлять рога | изменять (супругу)
наступить себе на горло | заставлять себя действовать против воли, желаний, сознательно сдерживать себя
наткнуться на стену | застопориться, не иметь возможности идти дальше
начать с чистого листа | начать сначала
не в бровь, а в глаз | очень точно (о замечании)
не в своей тарелке | неуверенно, неловко
не верить своим глазам | не верить очевидному
не видеть дальше собственного носа | о человеке, который видит всё только вокруг себя?
не всё коту масленица / не всё коту масленица, будет и великий пост | о том, что период благополучия может закончиться
не давать покоя | приставать
не для слабонервных | о чём-либо страшном
не за горами | скоро, близко (о времени)
не иметь выбора | быть вынужденным поступить именно так
не к месту | не нужен именно здесь, мешает
не лыком шит | не так прост, как кажется
не мудрствуя лукаво | не долго думая
не находить себе места | сильно переживать
не по мне | не нравится
не по себе / как-то не по себе / не по себе как-то | чувствовать себя плохо
не по чьей-либо части | он в этом не разбирается
не покладая рук / работать не покладая рук / не покладая рук работать | прилежно работать, работать сверх норм?
не проведёшь | не обманешь
не то слово | восклицание, означающее высшую степень похвалы
не ударить в грязь лицом | не опозориться, не потерять достоинство
не успеешь глазом моргнуть | очень быстро
не успеешь оглянуться | очень быстро
небо и земля | об очень большой разнице
невооружённым глазом | сразу видно
недалёкого ума | глупый
незапамятные времена | очень давно
нельзя ли для прогулок подальше выбрать закоулок? | призыв покинуть место
неотъемлемая часть | обязательная часть
непреклонное правило / непреложное правило | правило, которое нельзя нарушить
несмотря ни на что | преодолевая трудности
несолоно хлебавши | вернуться бесприбыльно?
нести свой крест | делать что-либо несмотря на тяжесть
нет слов | нечего сказать
нечист на руку | нечестен, занимается мелким воровством
ни бе ни ме (в чём-либо) | некомпетентен в данном вопросе
ни бельмеса | ничего (не знать, не понимать)
ни Богу свечка ни чёрту кочерга | предик., разг. 1. о ничем не выделяющемся, среднем, заурядном человеке, не отличающемся яркими свойствами или особенностями, не способном на активные, самостоятельные поступки (обычно с оттенком неодобрительности) 2. о чём-либо невыразительном, посредственном
ни больше ни меньше | ни больше ни меньше, именно это
ни в жизнь | никогда, ни за что
ни в зуб ногой / ни в зуб ногой, ни в нос ботинком | некомпетентен в данном вопросе
ни в какие ворота / не лезет ни в какие ворота / ни в какие ворота не лезет | совершенно неприемлемо
ни в одном глазу | абсолютно трезв; абсолютно не хочет спать
ни гроша за душой | очень беден
ни гу-гу | молчать
ни души | никого
ни за какие коврижки | ни при каких условиях, никогда
ни за что на свете | ни при каких условиях, никогда
ни к селу ни к городу | неуместно
ни копейки | ??
ни на йоту | ни на сколько
ни рожи ни кожи | неприметный человек
ни рыба ни мясо | никак, никакой
ни с того, ни с сего | вдруг
ни свет ни заря | очень рано
ни себе ни людям | никому
ни слуху ни духу | пропасть бесследно
ни сном ни духом | вообще не знать о чём-либо
ни стыда ни совести | о том, кто сделал что-либо пошлое, предосудительное
ни то ни сё | никак, никакой
ни туда ни сюда | никуда; оставаться на месте
ни уха ни рыла не смыслить | быть некомпетентным в чём-либо, ничего не понимать
низкого пошиба | низкопробный, некачественный; низкого происхождения
никаких «но» | без возражений, без оправданий, выполнять беспрекословно
нить Ариадны | метод выхода из сложной ситуации, помощь
ничего особенного | что-либо обычное
ноль внимания | полное равнодушие к чему-либо
носиться как с писаной торбой | очень бережно к чему-либо относиться
ну и ну! | выражение удивления
обвести вокруг пальца | Обмануть
обещать золотые горы | Обещать много невыполнимого
ободрать как липку | C легкостью обворовать
обойдется | Пройдет само собой
обреченный на успех | Неизбежный успех
объедки с барского стола | Оставшееся после господ кушанье, которое обычно отдавали в людскую
овчинка выделки не стоит | О пустяковом деле, которое потребует больше сил, чем принесет результата
одержать верх | Победить, выиграть
одетый с иголочки | Одетый модно, дорого, красиво (шикарно)
один как сыч | Одинокий человек
одним махом | За один раз
одним миром мазаны | Равноправны, заняты одним делом
одно на уме | Думает только об одном
одного круга | Равного положения
одного поля ягоды | Равноправны
одной левой | Легко победить
оказать почётный приём | Проявить гостеприимство
олимпийское спокойствие | Полное спокойствие
опускать руки | Сдавать, прекращать прилагать усилия в каком-нибудь деле ввиду его большой сложности или невозможности достижения успеха
Опять/снова за своё | О поведении человека, возвращающегося к какой-нибудь форме поведения, к совершению какого-либо действия
Орать (кричать) благим матом | Ругаться
орать как резаный | Орать очень громко, истошно
освежить память | Напомнить, вспомнить
освоить азы | Научиться основам чего-либо
осиное гнездо | О собрании склочных людей
оставаться в стороне | Не принимать участия в чем-либо
оставить след | Сделать что-нибудь для общего дела
отставной козы барабанщик | Человек, занимающий несерьезную должность
остаться в дураках | Остаться обманутым
остаться с носом | Остаться обманутым, ничего не получить
острые ощущения | Очень сильно, резко выраженные ощущения
от всего сердца | Искренне
от горшка два вершка | Маленький
от души | Искренне, от всего сердца
от зубов отскакивать | Знать очень хорошо
От корки до корки | От начала до конца, целиком (прочитать, исписать, выучить и т.п.)
От чистого сердца | Искренне
Отбить интерес/желание | Лишить желания заниматься чем-либо
отбиться от рук | О непослушном человеке (ребенке)
отбросы общества | Ненужные, никчемные люди
отвлекающий маневр | Совершение действия, отвлекающего от главного
отдавать честь | Приветствие (в армии, войсках)
отдать должное | Выражение одобрения действиям кого-либо
отделаться легким испугом | Избежать тяжелых последствий при каком-нибудь неблагоприятном случае
отделять овец от козлищ | Отделять овец от козлищ
откинуть копыта | Умереть, погибнуть
отклоняться от темы | Говорить не о том, о чем нужно (о чем спрашивают)
открыть Америку | «Открыть» что-то давно известное
открыть кому-л глаза на что-л | Разъяснить, показать очевидное
откуда ни возьмись | О неожиданном появлении кого-либо или чего-либо
отложить в долгий ящик | Отложить какие-либо дела на долгое время
отложить на потом | Принять решение заняться каким-то делом не сейчас, а в будущем
отмывать деньги | Легализовать средства, полученные преступным путем
оторваться от коллектива | Не совершать чего-либо, что делают все
Оторви и выбрось/брось | О ненужной вещи
отплатить той же монетой | Отомстить схожим образом
отправить к праотцам | Убить, умертвить
отправить на тот свет | Убить, умертвить
отрезанный ломоть | О сироте, ребенке, чужом в собственной семье
очертя голову | С жаром, с энтузиазмом
Павлик Морозов | Имя нарицательное для человека, который предает свою собственную семью, в особенности, отца. В настоящее время Павлик Морозов воспринимается в основном с негативным оттенком, этакий маленький Иуда.
падать с неба | унывать
пальма первенства | Лидерство в чем-либо, наилучший результат кого-либо сравнительно с остальными
пальцем в небо | Наугад
пальцем не пошевелить | ничего не делать
первый блин комом | О неудачном, плохо получившемся каком-либо деле, совершаемом в условиях отсутствия опыта
первый парень на деревне | Первый парень на деревне
первый среди равных | Первый среди равных
первым делом | Вначале
перегнуть палку | перестараться
передать эстафету | Передать эстафету
Перейти (через) Рубикон | Совершить действие с заведомо необратимыми последствиями.
перековать мечи на орала | Перестроиться с военного на мирный лад
Перемывать косточки (кости) | Злословить, сплетничать, судачить о ком-либо.
переполнить чашу терпения | Заставить нервничать
перепугаться до смерти | Испытать сильный страх
першить в горле | Першить в горле
пилотный проект | Экспериментальный проект
пир во время чумы | Пир во время чумы
питать слабость | Испытывать симпатию к кому-либо, выделять что-либо во вкусах и предпочтениях
пиши пропало | Пиши пропало
пища богов | очень вкусная пища
пища для размышления | Данные, на основе которых можно делать выводы, рассуждать
Плакать/плакаться в жилетку | Жаловаться кому-либо на свою жизнь
плевать в потолок | Ничего не делать
плести небылицы | Плести небылицы
плоская острота | Несмешная шутка
плыть по течению | Подчиняться влиянию обстоятельств, ходу событий
плюнуть в душу | Обидеть
плясать под чью-л дудку | Действовать, подчиняясь чьему-либо руководству
по всему видно | По всему видно
по первое число всыпать | Сильно наказать
по последнему слову техники | По последнему слову техники
по пьяной лавочке | Спьяна, находясь в нетрезвом состоянии
по пятам | Следом
по сердцу | По сердцу
по уши | Полностью
победила дружба | Говорится, когда в каком-либо соревновании, состязании борющиеся стороны достигли одинакового, равного результата
поверить на слово | Поверить чьим-нибудь словам, не проверяя то, что в них утверждается
повернуть время вспять | Вернуть время назад
поговорить по душам | Поговорить по душам
погрязнуть в рутине | Погрязнуть в рутине
Под (большим) вопросом | О чем-то сомнительном, не известном точно
под каблуком | Под сильным контролем жены
под мухой | Спьяна, находясь в нетрезвом состоянии
Под шефе/шофе | Спьяна, находясь в нетрезвом состоянии
Подавать (большие) надежды | Подавать (большие) надежды
подарок судьбы | Крайне благоприятное событие
подвести под монастырь | Подставить
поддерживать связь | Поддерживать связь
поджав хвост | Поджав хвост
поджилки трясутся | О сильном страхе
подлить масла в огонь | Еще больше усугубить
подложить свинью | Подложить свинью
подноготная правда | Подноготная правда
подносить хлеб-соль | Подносить хлеб-соль
поднять на щите | Поднять на щите
подрезать автомобиль | Подрезать автомобиль
подставлять кого-либо под удар | Подставлять кого-либо под удар
поезд ушел | Об упущенной возможности
поживем - увидим | Подождем, посмотрим, что дальше будет
пожинать лавры | Пожинать лавры
пожинать плоды | Пожинать плоды
позолотить ручку | Дать денег
пойти под оконья | Пойти под оконья
Пока суд/суть да дело | Пока суд/суть да дело
показать, где раки зимуют | Выражение угрозы
показать кузькину мать | Угроза (часто шутливая)
ползти как улитка | Ползти как улитка
поливать грязью | Оскорблять
Положа руку на сердце | Очень честно
положение хуже губернаторского | Затруднительное положение
положить глаз | Заинтересоваться
положить зубы на полку | влачить нищенское существование, жить впроголодь.
положить под сукно | Оставить без внимания
полоса везения | Когда очень везет, всё получается
получить на орехи | Получить на орехи
получить по шее | Быть наказанным
помяни моё слово | Вспомни, что я говорил
понимать с полуслова | Хорошо понимать
Попал как кур во щи/в ощип | Попал как кур во щи/в ощип
попасть в самую точку | Попасть в самую точку
попасть впросак | Попасть впросак
попасться на удочку | Попасться на удочку
попахивать неприятностями | Попахивать неприятностями
попробовать себя в чем-либо | Попробовать себя в чем-либо
попробуй пойми | Попробуй пойми
пораскинуть мозгами | Поразмыслить, обдумать что-нибудь
послать подальше | Послать подальше
после дождичка в четверг | Никогда
после драки кулаками махать | Не оставлять событие в покое после его завершения
последнее китайское предупреждение | Ироническое выражение, подразумевающее то, что последних предупреждений может быть несколько.
последняя капля | Событие, на котором закончилось терпение человека
Последняя/высшая инстанция | Человек, который принимает окончательное решение
Поссориться/рассориться в пух и прах | Очень сильно испортить отношения с кем-либо
Поставить (не) на ту лошадку | Поставить (не) на ту лошадку
Поставить на (свое) место | Одернуть
поставить точку | Завершить какое-либо дело
постоять за себя | Защититься
посыпать голову пеплом | Выражение сожаления, раскаяния в совершенном поступке, действии
потерянное время | Время, которое было потрачено даром, без всякой пользы
почивать на лаврах | Не стремиться к новым достижениям, довольствуясь почетом, возникшем в результате прошлых свершений
почить в бозе | Перестать существовать
почуять неладное | Почувствовать, что происходит что-то нехорошее
правда-матка | Правда-матка
предоставить самому себе | Предоставить самому себе
Предпринимать меры/шаги | Предпринимать меры/шаги
прекрасный пол | Женский пол
пресечь в зародыше | Ликвидировать что-либо нежелательное, пока оно не успело развиться, развернуться из начального состояния
пресечь на корню | Пресечь на корню
при полном параде | В максимально нарядном виде
при таинственных обстоятельствах | При таинственных обстоятельствах
при царе Горохе | В неопределенно древние времена
привлечь внимание | Привлечь внимание
пригласительный билет | Пригласительный билет
пригодиться | Пригодиться
Пригреть змею на груди (за пазухой) | Когда на добро, которое совершил в адрес другого, тот отвечает злом
придавать огромное значение | Придавать огромное значение
придираться к мелочам | Придираться к мелочам
прижать к стене | Прижать к стене
прийти в себя | Восстановить свою способность думать, соображать, чувствовать(после обморока, контузии и т. п.), опомниться, успокоиться
призрачный шанс | Очень слабый шанс, малая благоприятная возможность чего-либо
прийти к шапочному разбору | Прийти к шапочному разбору
прийтись не ко двору | Прийтись не ко двору
принимать во внимание | Принимать во внимание
принимать желаемое за действительное | Принимать желаемое за действительное
принимать за чистую монету | Верить чему-либо неправдивому, чьему-либо обману
Принять (на грудь) с утра пораньше | Выпить алкоголя в утреннее время
принять близко к сердцу | Сильно переживать о чем-либо
природа отдохнула | "На нем природа отдохнула" - о человеке, который не обладает особыми талантами, внешностью, и т.д.
природа свое возьмет | Природа свое возьмет
притча во языцах | То,что все обсуждают
притянутый за уши | Неаргументированный, взятый с потолка, малодоказательный, не подкрепленный доказательствами, притянутый за волосы, неосновательный, недоказательный, голословный, безосновательный, неправомерный, несостоятельный, необоснованный, беспочвенный
проверка на вшивость | Испытание, которое устраивают, чтобы проверить заинтересованность человека в общем деле
проглотить обиду | Проглотить обиду
прогнить до основания | Прогнить до основания
пройти испытание временем | Пройти испытание временем
пройти огонь, воду и медные трубы | Пережить жизненные испытания, тяжелые ситуации
прокрустово ложе | Ограничение, согласно которому приходится сократить, урезать что-либо
пропащая душа | Пропащая душа
пропивать мозги | Совершать неразумные поступки в связи со злоупотреблением алкоголем
пропускать мимо ушей | Игнорировать какую-либо информацию, чьи-либо замечания
просиживать штаны | Бездельничать, ничем не заниматься
просто так! | По собственному необоснованному желанию, либо без определенной причины
протянуть ноги | Умереть
протянуть руку помощи | Оказать помощь, поддержку кому-либо
профессор кислых щей | Профессор кислых щей
проходной двор | Место, где ходит много людей
проще пареной репы | О чем-то элементарном, простейшем
пруд пруди | Большое количество
прыгать от радости | Испытывать огромную радость, эйфорию
прятать голову в песок | В кризисной ситуации вести себя так, как будто тебя это не касается
псих ненормальный | О человеке, который ведет себя взбалмошно, неуравновешенно
Пуд соли съесть (вместе) | Дружить долгое время
пуп земли | О эгоцентричном человеке, который преувеличивает свое значение
пускать пыль в глаза | Стараться произвести необоснованно хорошее впечатление на кого-либо
пустить козла в огород | Допустить кого-либо к такой сфере/делу, в котором он будет заинтересован сделать что-либо разрушительное для этой сферы/дела
пуститься во все тяжкие | Дойти до такой степени распущенности, когда в поведении практически отсутствуют моральные нормы
путь наименьшего сопротивления | Тактика поведения, требующая приложения минимальных усилий
пятое колесо | лишний элемент или лишний человек в каком-либо деле.
работа не бей лежачего | Легкая работа
работать допоздна | Работать допоздна
Работать за троих/семерых | Много работать
работать на износ | Работать себе во вред, не жалея себя
Работать сутками/круглосуточно | Много работать
раз два и обчелся | Мало
раз плюнуть | Возможность для кого-либо сделать что-то без особого труда
разбить наголову | Превзойти во много раз
развесить уши | Быть чрезмерно доверчивым
разведывать обстановку | Узнавать информацию о происходящем
развеять миф | Рассказать правду о чем-либо
разводить антимонию | вести пустые, излишне долгие и отвлекающие от чего-либо серьёзного разговоры; проявлять излишнюю мягкость, снисходительность в отношениях с кем-либо.
развязать кому-л руки | Позволить другому что-либо сделать
разделать под орех | Очень сильно отругать
Раздуть/поднять шум/шумиху вокруг | Привлечь множество внимания к какому-либо событию в своих целях
Разжечь/подогреть интерес | пробудить интерес
рань несусветная | Очень ранний час
раскритиковать в пух и прах | сильно раскритиковать
раскрыть карты | Сделать что-либо в открытую
расправить крылья | Почуствовать себя свободным
распустить хвост | Хвастаться, показывать себя с выгодной стороны
рассиживаться как квашня | Проводить время в позорном бездействии
расставить точки над i | окончательно разобраться что к чему
расстроить планы | Расстроить планы
расхлебывать кашу | Решать проблемы
рвать волосы на голове | Отчаиваться, сожалеть
рвать и метать | Быть в бешенстве
реветь белугой | Издавать громкие протяжные звуки, обычно по отношению к плачу.
резать правду-матку | Говорить неприятную правду
резать ухо | Неприятно на слух
решетом воду носить | Бесполезное дело
рог изобилия | Рог изобилия
родиться в сорочке | О человеке, который чудом остался в живых
родственная душа | Близкий по духу человек
рождённый ползать летать не может | 
розовые очки | Слишком позитивное восприятие мира
руки в брюки | В бездействии
рукой подать | Очень близко
Руку/голову даю на отсечение | Ручаюсь
рыльце в пуху | Очевидная причастность к какому-то нехорошему делу
Рыться в (чьем-либо) грязном белье | Обсуждать интимные подробности
с азов | С самого начала
с блеском | Отлично справиться с чем-либо
С бородой (анекдот/шутка) | очень старый
с бухты-барахты | Вдруг, ни с того, ни с сего
с высоты птичьего полёта | с большой высоты; смотреть на ситуацию/вещи глобально
с гулькин нос | Очень мало
с замиранием сердца | С замиранием сердца
с иголочки | Совершенно новый
с корабля на бал | Ряд удач
с красной строки | С красной строки
скопытиться | Умереть
с лёгким паром | С лёгким паром
с нуля | С самого начала
с огня да в полымя | Ряд неудач
с пеной у рта | Рьяно доказывать
С поличным (поймать/взять);(явится) | Застукать на месте, с неопровержимыми уликами; Сдаться в руки правосудия
С полной отдачей (работать) | С полной отдачей (работать)
с праздником! | С праздником!
с протянутой рукой | Просить милостыню
с пустыми руками | С пустыми руками
с распростертыми объятиями | Радушный приём
с сердцем | С любовью
с умом | С умом
сады Семирамиды | Что-то чудесное
сам себе хозяин | Сам себе хозяин
само по себе | Само по себе
само собой разумеется | Само собой разумеется
сбить с панталыку | Запутать (в рассуждениях)
сбить с толку | Обмануть
сбиться с ног | Хлопотать до изнеможения
сборная солянка | Сборная солянка
свежо предание, а верится с трудом | 
Свет клином (не) сошёлся | О ком-то, кто неожиданно оказался в центре внимания (или наоборот - ему можно найти замену)
светлая голова | Светлая голова
сводить концы с концами | Жить в бедности, "от получки до получки"
свой парень | Свой парень
связать по рукам и ногам | Не дать возможности что-то сделать
связываться с кем-либо | Связываться с кем-либо
священная корова | Священная корова
Сгорать от/со стыда | Сильно стыдиться
сдвигаться с мёртвой точки | Сдвигаться с мёртвой точки
сделать исключение из правил | Сделать исключение из правил
сделать кого-л орудием в своих руках | Сделать кого-л орудием в своих руках
сделать поблажку | Сделать поблажку
себе во вред | Себе во вред
себе на уме | О молчаливом человеке
северная Пальмира | образное название Санкт-Петербурга
седьмая вода на киселе | Очень дальний родственник
секрет Полишинеля | Секрет Полишинеля
семимильными шагами | Очень быстро
семь пядей во лбу | Очень умный человек
семь футов под килем | Семь футов под килем
сердце не лежит | Что-то не нравится
сермяжная правда | Сермяжная правда
серый кардинал | Кукловод, не желающая привлекать внимание к своей персоне личность, которая управляет людьми, имеющих доступ к значительным ресурсам
сесть в калошу | Оказаться в неудобном положении
сжечь дотла | Сжечь дотла
сидеть как на иголках | Волноваться
сидеть на голодном пайке | Иметь недостаточно ресурсов
сидеть на шее | Жить за чужой счёт
сидеть сложа руки | Ничего не предпринимать
сизифов труд | Бесполезный труд
сильная сторона | Сильная сторона
Сильные мира сего | О людях, занимающих высокое общественное положение
сирота казанская | Сирота казанская
сказка про белого бычка | О длинной, бесконечной истории (при этом часто занудной)
скатертью дорога | Изначально - лёгкого, безопасного пути. Сейчас - выражение безразличия, что кто-то ушёл.
скидываться на что-либо | Скидываться на что-либо
склеить ласты | Умереть
сколько душе угодно | Много
сколько лет, сколько зим | Доброжелательное приветствие при встрече лиц, которые долго не виделись
скрежетать зубами | Досадовать, злобствовать
скрепя сердце | Против желания
слабое место | Там, где тонко
слезливая история | История, вызывающая чувство жалости, жалостливая история
сливки общества | Элита
словесный понос | Безудержный поток слов
сломя голову | Быстро бежать
служить посмешищем | Быть объектом насмешек
слюнки текут | Очень аппетитное
смекнуть что к чему | Понять, найти суть проблемы
сморозить глупость | Сказать глупость
смотать удочки | Закончить деятельность
смотреть в рот | Смотреть в рот
смотреть как баран на новые ворота | Не понимать, находиться в иступлении, смотреть как никогда не видев (слышав, знав) прежде
смотреть правде в глаза | Принимать истинное положение дел
смягчить удар | Уменьшить последствия
сносить крышу | Сносить крышу
со щитом или на щите | Победить или умереть
со всех ног | очень быстро
собаку сьесть | Знать и уметь что-то очень хорошо, иметь в этой области большой опыт
соблюдать приличия | Соблюдать приличия
совать палки в колеса | Мешать что-то сделать
соваться в чужие дела | Соваться в чужие дела
содом и Гоморра | суматоха, шум (используется название двух городов, уничтоженных богом за грехи, это происходило с большим шумом и разрушениями)
сойти с праведного пути | Сойти с праведного пути
сойти с проторенного пути | Сойти с проторенного пути
соломенная вдова | Соломенная вдова
сор из избы выносить | Сор из избы выносить
сорвать банк | Выиграть очень крупную сумму денег, поставленную на кон
сорвать башню | Сорвать башню
сорить деньгами | Сорить деньгами
сорока на хвосте принесла | Сорока на хвосте принесла
сохранить присутствие духа | Сохранить присутствие духа
спасать шкуру | Спасать шкуру
спать как убитый | Очень крепко
спать на ходу | Спать на ходу
спать стоя | Спать стоя
Спокон веков (испокон веку) | Спокон веков (испокон веку)
спорный вопрос | Спорный вопрос
спуститься на землю | Спуститься на землю
спустя рукава | Небрежно
Спутать (все) карты | Спутать (все) карты
сражаться с ветряными мельницами | Сражаться с ветряными мельницами
средней паршивости | Средней паршивости
срывать завесу | Срывать завесу
ставить во главу угла | Ставить во главу угла
ставить под сомнение | Ставить под сомнение
ставить подножку | Ставить подножку
ставить точку | Ставить точку
стать поперек горла | Стать поперек горла
стереть в порошок | Уничтожить
стерпится-слюбится | Смирение
сто к одному | Сто к одному
стоить целое состояние | Очень большие деньги, большая стоимость
стоять на своём | Не уступать
стоять над душой | Занудствовать
страшно подумать | Страшно подумать
строить глазки | Флиртовать
строить из себя | Пытаться выглядеть желаемым образом в глазах окружающих
стукнуть кулаком | Решительно потребовать
судьба улыбается кому-либо | Удача кого-либо
суета сует | Преходящее
сулить золотые горы | 
сущее наказание | Доставляющее большие хлопоты, заботы, проблемы
сферический конь | (матем.)
сходить с рук | Отсутствие наказания за содеянное
сходить с ума | Бредить (мечтать) о чём(ком)-либо, лишаться разума, терять контроль
сходить со сцены | Окончание периода популярности, деятельности
считать ворон | Быть рассеянным, невнимательным, несосредоточенным на нужном
сыграть в ящик | Умереть
сыпать соль на рану | Затрагивать тему, причиняющую душевную боль
сыт по горло | Нежелание продолжать
так (я) и знал | Свершение предполагаемого события
так было угодно судьбе | Смирение
так держать | Одобрение
так себе | Средняя оценка (ни плохо, ни хорошо)
тамбовский волк тебе товарищ | Недружелюбие
танцевать от печки | 
Тараканы в голове | Тараканы в голове
тарелочка с голубой каемочкой | В отношении несбыточных желаний ("принесут на тарелочке с голубой каёмочкой")
твёрдо стоять на ногах | Иметь прочный задел
Твердый/крепкий орешек | Твердый/крепкий орешек
театр начинается с вешалки | Обращение внимания на мелочи, детали
тепленькое местечко | Место, где хорошо получают и меньше работают
терновый венец | Издевательский венец из терновых ветвей, которым был увенчан распятый Иисус Христос. Существует морская звезда с таким названием
тёртый калач | Бывалый
Типун (кому-либо) на язык | Не дай бог
тише воды ниже травы | Существование с минимальным привлечением внимания к своей персоне
ткнуть носом в | Указать, показать, доказать
то что надо | Что и требовалось
только его и видели | Исчезнуть из виду
точить зуб | таить злобу
точить лясы | Болтать
тревожить душу | Волновать
трепать языком | Болтать
третий Рим | Москва
Третий сорт-не брак | Третий сорт-не брак
трещать без умолку | Болтать
трещать по швам | Не выдерживать нагрузок, непрохождение проверки
тришкин кафтан | Тришкин кафтан
трубка мира | Трубка мира
трястись над каждой копейкой | Жадничать
тугой на ухо | Плохо слышащий
туз в рукаве | Обеспечение выигрыша
тупиковая ситуация | Отсутствие вариантов решения проблемы
тютелька в тютельку | Точность как в аптеке
тяжелый на подъем | Тяжелый на подъем
тянуть время | Оттягивать наступление нужного момента
тянуть кота за хвост | Медлить
Тянуть/вытягивать клещами | Проблематичность получения необходимых сведений
Тяп-ляп и готово/сделано | Не аккуратно
у всех на слуху | Обсуждаем, известен
у разбитого корыта | (Остаться) ни с чем
у чёрта на куличках | Далеко. В месте, куда трудно добраться
увенчать лаврами | Наградить как победителя
удар ниже пояса | Подлый удар
ударить в грязь лицом | Опозориться
удобства во дворе | Неудобства
уйти по-английски | Уйти не прощаясь
указать на дверь | Прогнать из дома
укромный уголок | Укромный уголок
уложиться в срок | Успеть сделать что-либо за отведенное для этого время
ум за разум заходит | О чем-нибудь сложном для понимания
Ума палата (а ключ потерян) | (иронич.) О человеке, который кажется себе очень умным, на самом деле это не так
умывать руки | Отказываться от продолжения участия в каком-то деле
упасть духом | Расстроится, поверить в безнадёжность
упрямый как осел | Очень упрямый
устроить сцену | Устроить крупный разговор, излишне эмоциональное объяснение, ссору
усыплять бдительность | Ослаблять внимание к чему-либо
утереть нос | Доказать свое превосходство над кем-то, одержать победу над кем-то
утечка мозгов | Утечка мозгов
ушки на макушке | Слушать с предельным вниманием
уязвимое место | Уязвимое место
Федот, да не тот | Не то чем представлялось в начале
философский камень | Философский камень
филькина грамота | Документ, не представляющий никакой силы, или же вызывающий сомнения/недоверие/игнорирование второй стороной
Фома да Ерёма | Фома да Ерёма
Фома неверующий | Недоверчивый, во всем видит подвох
форменная обдираловка | Форменная обдираловка
хватит ковырять в носу | Прекрати заниматься пустым делом!
хлеба и зрелищ | Удовлетворение потребностей народа властью
хлебом не корми | Энтузиаст
хлеб-соль | Гостеприимство, радушие
хляби небесные | Сильные, обильные осадки
ходить вокруг да около | Не касаться сути
ходить на задних лапах/лапках | Лебезить
ходить налево | Блудить
ходить по струнке | Строгая дисциплина
ходить фертом | Важничать
хорошенького помаленьку | Умереность в удовольствиях
хотите верьте хотите нет | Информация к размышлению
хоть бы хны | Не больно, безразлично
хоть кол на голове теши | Непослушание, безразличие
хоть пруд пруди | Много
хоть трава не расти | Безразличие к последствиям
хоть убей, не знаю | Точно не знаю
хоть шаром покати | Пусто
хранить как зеницу ока | Самое дорогое
хуже горькой редьки | Очень неприятное
цепляться к мелочам | Привередничать
царевна Несмеяна | Депрессивный человек
цепкий ум | Склонность к анализу
цепляться за соломинку | Прибегать к последнему средству, даже слабому
цвести и пахнуть | Быть привлекательным(ой) и в хорошем расположении духа
час пик | Частичная калька с англ. peak hour
человеческий фактор | Человеческий фактор
чепуха на постном масле | Бред
через мой труп | ни за что!
через одно место | сделано очень плохо
через пень-колоду | Кое-как
черепашьим шагом | Медленно
черкнуть пару строк | Написать немного
черный как трубочист | Грязный
черный нал | Черный нал
чёрным по белому | Понятно,ясно
чёрт ногу сломит | Очень криво,косо-непонятно
читать мысли | Читать мысли
что было - то было | Что было - то было
чтоб тебе пусто было | Чтоб ты пропал
чувство локтя | Ощущение поддержки
чувствовать себя как дома | Чувствовать себя как дома
чувствовать себя как рыба в воде | Чувствовать себя очень хорошо где-нибудь
чужими руками жар загребать | Чужими руками жар загребать
чушь собачья | 100%-я чепуха
шапочное знакомство | Поверхностное знакомство
шарашкина контора | Несолидное, не вызывающее доверия учреждение, предприятие, организация.
шевелить поршнями | Двигай ногами, отсюда
шевелить мозгами | Думать
шерочка с машерочкой | ирон. - о двух подругах.
Шиворот-навыворот | Наоборот, совсем не так, как нужно.
шило в одном месте | Непоседа, беспокойный человек
шкурный интерес/вопрос | Личная заинтересованность, выгода
шут гороховый | Пустой человек, чудак, служащий всеобщим посмешищем.
шутки в сторону | Призыв к серьезности
щекотливая ситуация | Неловкая, неудобная ситуация
эликсир жизни | (книжн.) о том, что бодрит, придаёт силы.
Это (не) по-нашему | В соответствии/не в соответствии с принятыми (в данном обществе) нормами
этот номер не пройдёт | Что-то не удастся
яблоко раздора | (книжн.) повод, причина ссоры, спора, серьёзных разногласий
явился — не запылился | (прост. неодобр.) выражение раздражения по поводу чьего-либо нежелательного прихода.
яко тать в нощи | (книжн.) неожиданно, внезапно
яйца выеденного не стоит | совершенно бесполезная вещь
язык сломать можно, язык сломаешь | Очень трудно выговорить
японский городовой | эвфемизм нецензурной брани